ANTIPASTI
Misto della casa | Mixed local cheese, ham and vegetables €20
Treccia alla brace con Parma | Grilled local mozzarella with raw ham €10
Frittura all'italiana | Mixed italian fried food (potatoes crocchè, mozzarella fried and rice balls aubergines fried) €10
Frittura calamaretti e zucchine | Fried squids and zucchini  €15 
Misto di verdure | Mixed vegetables  €10
Alici e lambuca marinati | Marinated local fish €1
Carciofi dorati e fritti | Fried artichokes €6 
PRIMI
Pasta fagioli e cozze | Pasta beans and mussels €10
Ravioli capresi | Homemade pasta stuffed with cheese and mozzarella covered with cherry tomatoes €10
Gnocchi alla sorrentina | potatoes gnocchi with tomato sauce, mozzarella and basil €10
Paccheri con funghi porcini e noci | Pasta with mushrooms and nuts €10
Scialatielli broccoli e salsiccia | Homemade pasta with broccoli and sausage €10
Risotto alla pescatora | Risotto with seafood €18
SECONDI
Misto di pesce alla brace | Mixed grilled fish (squids, prawns and slice of local fish) €20
Misto di carne alla brace | Mixed grilled meat (sausage, steak, cutlet and chicken) €18
Frittura di pesce mista | Mixed fried fish (squids, shrimp and anchovies) €18
Angiola gratinata | Local fish au gratin €15
Bistecca alla brace | Grilled steak €18
Entrecote ai funghi porcini | Entrecote with porcini mushrooms €18
PIZZE
Pizza 4 stagioni | Pizza four seasons €10
Pizza Margherita: pomodoro, mozzarella e basilico | Tomato sauce mozzarella and basil €6
Pizza Marinara: olio, pomodoro, aglio e origano | Tomato sauce, basil,origano,garlic €5
Pizza Diavola: pomodoro, mozzarella e salame piccante | Tomato sauce, mozzarella and spicy salami €8
Pizza Pancetta e cipolla | Mozzarella, bacon and onions €8
Pizza con parmigiana di melanzane: mozzarella, pomodoro e melanzane a fette | Tomato sauce and baked parmigiana  €8
Pizza Capricciosa: mozzarella, pomodoro, funghi, olive, salsiccia e prosciutto cotto | Tomato sauce, mozzarella, aubergines, sausage, olives, mushrooms and ham €8
Pizza con pomodorini, rucola, crudo e scaglie | Mozzarella, cherry tomatoes, roket salad, ham and parmesan cheese €8
Pizza pomodorini e provola | Mozzarella and cherry tomatoes €7
Focaccia caprese | Pizza bread with fresh tomatoes, mozzarella and basil €8
Pizza con melanzane e salsiccia: mozzarella, pomodoro, melanzane e salsiccia  | Tomato sauce, mozzarella, aubergines and sausage €8
Pizza Ortolana: mozzarella e verdure miste (grigliate e in padella) | Mozzarella and mixed vegetables €8
Pizza broccoli e salsiccia: mozzarella, broccoli e salsiccia | Mozzarella, broccoli and sausage €8
Specialità del pizzaiolo
Pizza zucchini e provolone: mozzarella, zucchini fritti e provolone | Mozzarella, zucchini fried and provolone cheese €9
Pizza scarola, caciotta e noci: mozzarella, noci e scarola stufata con oilve e uvetta passa | Mozzarella, escarole salad, caciotta cheese and nuts €9
Pizza funghi porcini, salsiccia e patate al forno: mozzarella, funghi, salsiccia e patate al forno | Mozzarella, sausage, porcini mushrooms and baked potatoes *1 2 3 4 5 6 7 8 9 10 11 12 13 14 15 €9
